"gamesId","year","hostCity","countryCode","countryName","rank","gold","silver","bronze","total"
27,2012,"London","USA","United States",1,46,29,29,104
27,2012,"London","CHN","China",2,38,27,23,88
27,2012,"London","GBR","Great Britain",3,29,17,19,65
27,2012,"London","RUS","Russia",4,24,26,32,82
27,2012,"London","KOR","South Korea",5,13,8,7,28
27,2012,"London","GER","Germany",6,11,19,14,44
27,2012,"London","FRA","France",7,11,11,12,34
27,2012,"London","ITA","Italy",8,8,9,11,28
27,2012,"London","HUN","Hungary",9,8,4,5,17
27,2012,"London","AUS","Australia",10,7,16,12,35
27,2012,"London","JPN","Japan",11,7,14,17,38
27,2012,"London","KAZ","Kazakhstan",12,7,1,5,13
27,2012,"London","NED","Netherlands",13,6,6,8,20
27,2012,"London","UKR","Ukraine",14,6,5,9,20
27,2012,"London","NZL","New Zealand",15,6,2,5,13
27,2012,"London","CUB","Cuba",16,5,3,6,14
27,2012,"London","IRI","Iran",17,4,5,3,12
27,2012,"London","JAM","Jamaica",18,4,4,4,12
27,2012,"London","CZE","Czech Republic",19,4,3,3,10
27,2012,"London","PRK","North Korea",20,4,0,2,6
27,2012,"London","ESP","Spain",21,3,10,4,17
27,2012,"London","BRA","Brazil",22,3,5,9,17
27,2012,"London","RSA","South Africa",23,3,2,1,6
27,2012,"London","ETH","Ethiopia",24,3,1,3,7
27,2012,"London","CRO","Croatia",25,3,1,2,6
27,2012,"London","BLR","Belarus",26,2,5,5,12
27,2012,"London","ROU","Romania",27,2,5,2,9
27,2012,"London","KEN","Kenya",28,2,4,5,11
27,2012,"London","DEN","Denmark",29,2,4,3,9
27,2012,"London","AZE","Azerbaijan",30,2,2,6,10
27,2012,"London","POL","Poland",30,2,2,6,10
27,2012,"London","TUR","Turkey",32,2,2,1,5
27,2012,"London","SUI","Switzerland",33,2,2,0,4
27,2012,"London","LTU","Lithuania",34,2,1,2,5
27,2012,"London","NOR","Norway",35,2,1,1,4
27,2012,"London","CAN","Canada",36,1,5,12,18
27,2012,"London","SWE","Sweden",37,1,4,3,8
27,2012,"London","COL","Colombia",38,1,3,4,8
27,2012,"London","GEO","Georgia",39,1,3,3,7
27,2012,"London","MEX","Mexico",39,1,3,3,7
27,2012,"London","IRL","Ireland",41,1,1,3,5
27,2012,"London","ARG","Argentina",42,1,1,2,4
27,2012,"London","SRB","Serbia",42,1,1,2,4
27,2012,"London","SLO","Slovenia",42,1,1,2,4
27,2012,"London","TUN","Tunisia",45,1,1,1,3
27,2012,"London","DOM","Dominican Republic",46,1,1,0,2
27,2012,"London","TRI","Trinidad and Tobago",47,1,0,3,4
27,2012,"London","UZB","Uzbekistan",47,1,0,3,4
27,2012,"London","LAT","Latvia",49,1,0,1,2
27,2012,"London","ALG","Algeria",50,1,0,0,1
27,2012,"London","BAH","Bahamas",50,1,0,0,1
27,2012,"London","GRN","Grenada",50,1,0,0,1
27,2012,"London","UGA","Uganda",50,1,0,0,1
27,2012,"London","VEN","Venezuela",50,1,0,0,1
27,2012,"London","IND","India",55,0,2,4,6
27,2012,"London","MGL","Mongolia",56,0,2,3,5
27,2012,"London","THA","Thailand",57,0,2,1,3
27,2012,"London","EGY","Egypt",58,0,2,0,2
27,2012,"London","SVK","Slovakia",59,0,1,3,4
27,2012,"London","ARM","Armenia",60,0,1,2,3
27,2012,"London","BEL","Belgium",60,0,1,2,3
27,2012,"London","FIN","Finland",60,0,1,2,3
27,2012,"London","BUL","Bulgaria",63,0,1,1,2
27,2012,"London","EST","Estonia",63,0,1,1,2
27,2012,"London","INA","Indonesia",63,0,1,1,2
27,2012,"London","MAS","Malaysia",63,0,1,1,2
27,2012,"London","PUR","Puerto Rico",63,0,1,1,2
27,2012,"London","TPE","Chinese Taipei",63,0,1,1,2
27,2012,"London","BOT","Botswana",69,0,1,0,1
27,2012,"London","CYP","Cyprus",69,0,1,0,1
27,2012,"London","GAB","Gabon",69,0,1,0,1
27,2012,"London","GUA","Guatemala",69,0,1,0,1
27,2012,"London","MNE","Montenegro",69,0,1,0,1
27,2012,"London","POR","Portugal",69,0,1,0,1
27,2012,"London","GRE","Greece",75,0,0,2,2
27,2012,"London","MDA","Moldova",75,0,0,2,2
27,2012,"London","QAT","Qatar",75,0,0,2,2
27,2012,"London","SIN","Singapore",75,0,0,2,2
27,2012,"London","AFG","Afghanistan",79,0,0,1,1
27,2012,"London","BRN","Bahrain",79,0,0,1,1
27,2012,"London","HKG","Hong Kong",79,0,0,1,1
27,2012,"London","KSA","Saudi Arabia",79,0,0,1,1
27,2012,"London","KUW","Kuwait",79,0,0,1,1
27,2012,"London","MAR","Morocco",79,0,0,1,1
27,2012,"London","TJK","Tajikistan",79,0,0,1,1
26,2008,"Beijing","CHN","China",1,51,21,28,100
26,2008,"Beijing","USA","United States",2,36,38,36,110
26,2008,"Beijing","RUS","Russia",3,23,21,29,73
26,2008,"Beijing","GBR","Great Britain",4,19,13,15,47
26,2008,"Beijing","GER","Germany",5,16,10,15,41
26,2008,"Beijing","AUS","Australia",6,14,15,17,46
26,2008,"Beijing","KOR","South Korea",7,13,10,8,31
26,2008,"Beijing","JPN","Japan",8,9,6,10,25
26,2008,"Beijing","ITA","Italy",9,8,9,10,27
26,2008,"Beijing","FRA","France",10,7,16,18,41
26,2008,"Beijing","UKR","Ukraine",11,7,5,15,27
26,2008,"Beijing","NED","Netherlands",12,7,5,4,16
26,2008,"Beijing","KEN","Kenya",13,6,4,4,14
26,2008,"Beijing","JAM","Jamaica",14,6,3,2,11
26,2008,"Beijing","ESP","Spain",15,5,10,3,18
26,2008,"Beijing","BLR","Belarus",16,4,5,10,19
26,2008,"Beijing","ROU","Romania",17,4,1,3,8
26,2008,"Beijing","ETH","Ethiopia",18,4,1,2,7
26,2008,"Beijing","CAN","Canada",19,3,9,6,18
26,2008,"Beijing","POL","Poland",20,3,6,1,10
26,2008,"Beijing","HUN","Hungary",21,3,5,2,10
26,2008,"Beijing","NOR","Norway",22,3,5,1,9
26,2008,"Beijing","BRA","Brazil",23,3,4,8,15
26,2008,"Beijing","CZE","Czech Republic",24,3,3,0,6
26,2008,"Beijing","NZL","New Zealand",25,3,2,4,9
26,2008,"Beijing","SVK","Slovakia",26,3,2,1,6
26,2008,"Beijing","GEO","Georgia",27,3,0,3,6
26,2008,"Beijing","CUB","Cuba",28,2,11,11,24
26,2008,"Beijing","KAZ","Kazakhstan",29,2,4,7,13
26,2008,"Beijing","DEN","Denmark",30,2,2,3,7
26,2008,"Beijing","MGL","Mongolia",31,2,2,0,4
26,2008,"Beijing","THA","Thailand",31,2,2,0,4
26,2008,"Beijing","SUI","Switzerland",33,2,1,4,7
26,2008,"Beijing","PRK","North Korea",34,2,1,3,6
26,2008,"Beijing","ARG","Argentina",35,2,0,4,6
26,2008,"Beijing","MEX","Mexico",36,2,0,1,3
26,2008,"Beijing","TUR","Turkey",37,1,4,3,8
26,2008,"Beijing","ZIM","Zimbabwe",38,1,3,0,4
26,2008,"Beijing","AZE","Azerbaijan",39,1,2,4,7
26,2008,"Beijing","UZB","Uzbekistan",40,1,2,3,6
26,2008,"Beijing","SLO","Slovenia",41,1,2,2,5
26,2008,"Beijing","BUL","Bulgaria",42,1,1,3,5
26,2008,"Beijing","INA","Indonesia",42,1,1,3,5
26,2008,"Beijing","FIN","Finland",44,1,1,2,4
26,2008,"Beijing","LAT","Latvia",45,1,1,1,3
26,2008,"Beijing","BEL","Belgium",46,1,1,0,2
26,2008,"Beijing","DOM","Dominican Republic",46,1,1,0,2
26,2008,"Beijing","EST","Estonia",46,1,1,0,2
26,2008,"Beijing","POR","Portugal",46,1,1,0,2
26,2008,"Beijing","IND","India",50,1,0,2,3
26,2008,"Beijing","IRI","Iran",51,1,0,1,2
26,2008,"Beijing","CMR","Cameroon",52,1,0,0,1
26,2008,"Beijing","PAN","Panama",52,1,0,0,1
26,2008,"Beijing","TUN","Tunisia",52,1,0,0,1
26,2008,"Beijing","SWE","Sweden",55,0,4,1,5
26,2008,"Beijing","CRO","Croatia",56,0,2,3,5
26,2008,"Beijing","LTU","Lithuania",56,0,2,3,5
26,2008,"Beijing","GRE","Greece",58,0,2,2,4
26,2008,"Beijing","TRI","Trinidad and Tobago",59,0,2,0,2
26,2008,"Beijing","NGR","Nigeria",60,0,1,3,4
26,2008,"Beijing","AUT","Austria",61,0,1,2,3
26,2008,"Beijing","IRL","Ireland",61,0,1,2,3
26,2008,"Beijing","SRB","Serbia",61,0,1,2,3
26,2008,"Beijing","ALG","Algeria",64,0,1,1,2
26,2008,"Beijing","BAH","Bahamas",64,0,1,1,2
26,2008,"Beijing","COL","Colombia",64,0,1,1,2
26,2008,"Beijing","KGZ","Kyrgyzstan",64,0,1,1,2
26,2008,"Beijing","MAR","Morocco",64,0,1,1,2
26,2008,"Beijing","TJK","Tajikistan",64,0,1,1,2
26,2008,"Beijing","CHI","Chile",70,0,1,0,1
26,2008,"Beijing","ECU","Ecuador",70,0,1,0,1
26,2008,"Beijing","ISL","Iceland",70,0,1,0,1
26,2008,"Beijing","MAS","Malaysia",70,0,1,0,1
26,2008,"Beijing","RSA","South Africa",70,0,1,0,1
26,2008,"Beijing","SIN","Singapore",70,0,1,0,1
26,2008,"Beijing","SUD","Sudan",70,0,1,0,1
26,2008,"Beijing","VIE","Vietnam",70,0,1,0,1
26,2008,"Beijing","ARM","Armenia",78,0,0,6,6
26,2008,"Beijing","TPE","Chinese Taipei",79,0,0,4,4
26,2008,"Beijing","AFG","Afghanistan",80,0,0,1,1
26,2008,"Beijing","EGY","Egypt",80,0,0,1,1
26,2008,"Beijing","ISR","Israel",80,0,0,1,1
26,2008,"Beijing","MDA","Moldova",80,0,0,1,1
26,2008,"Beijing","MRI","Mauritius",80,0,0,1,1
26,2008,"Beijing","TOG","Togo",80,0,0,1,1
26,2008,"Beijing","VEN","Venezuela",80,0,0,1,1
25,2004,"Athens","USA","United States",1,35,39,29,103
25,2004,"Athens","CHN","China",2,32,17,14,63
25,2004,"Athens","RUS","Russia",3,28,26,38,92
25,2004,"Athens","AUS","Australia",4,17,16,16,49
25,2004,"Athens","JPN","Japan",5,16,9,12,37
25,2004,"Athens","GER","Germany",6,13,16,20,49
25,2004,"Athens","FRA","France",7,11,9,13,33
25,2004,"Athens","ITA","Italy",8,10,11,11,32
25,2004,"Athens","KOR","South Korea",9,9,12,9,30
25,2004,"Athens","GBR","Great Britain",10,9,9,13,31
25,2004,"Athens","CUB","Cuba",11,9,7,11,27
25,2004,"Athens","UKR","Ukraine",12,9,5,9,23
25,2004,"Athens","HUN","Hungary",13,8,6,3,17
25,2004,"Athens","ROU","Romania",14,8,5,6,19
25,2004,"Athens","GRE","Greece",15,6,6,4,16
25,2004,"Athens","BRA","Brazil",16,5,2,3,10
25,2004,"Athens","NOR","Norway",17,5,0,1,6
25,2004,"Athens","NED","Netherlands",18,4,9,9,22
25,2004,"Athens","SWE","Sweden",19,4,2,1,7
25,2004,"Athens","ESP","Spain",20,3,11,5,19
25,2004,"Athens","CAN","Canada",21,3,6,3,12
25,2004,"Athens","TUR","Turkey",22,3,3,4,10
25,2004,"Athens","POL","Poland",23,3,2,5,10
25,2004,"Athens","NZL","New Zealand",24,3,2,0,5
25,2004,"Athens","THA","Thailand",25,3,1,4,8
25,2004,"Athens","BLR","Belarus",26,2,6,7,15
25,2004,"Athens","AUT","Austria",27,2,4,1,7
25,2004,"Athens","ETH","Ethiopia",28,2,3,2,7
25,2004,"Athens","IRI","Iran",29,2,2,2,6
25,2004,"Athens","SVK","Slovakia",29,2,2,2,6
25,2004,"Athens","TPE","Chinese Taipei",31,2,2,1,5
25,2004,"Athens","GEO","Georgia",32,2,2,0,4
25,2004,"Athens","BUL","Bulgaria",33,2,1,9,12
25,2004,"Athens","JAM","Jamaica",34,2,2,1,5
25,2004,"Athens","UZB","Uzbekistan",34,2,1,2,5
25,2004,"Athens","MAR","Morocco",36,2,1,0,3
25,2004,"Athens","DEN","Denmark",37,2,0,6,8
25,2004,"Athens","ARG","Argentina",38,2,0,4,6
25,2004,"Athens","CHI","Chile",39,2,0,1,3
25,2004,"Athens","KAZ","Kazakhstan",40,1,4,3,8
25,2004,"Athens","KEN","Kenya",41,1,4,2,7
25,2004,"Athens","CZE","Czech Republic",42,1,3,4,8
25,2004,"Athens","RSA","South Africa",43,1,3,2,6
25,2004,"Athens","CRO","Croatia",44,1,2,2,5
25,2004,"Athens","LTU","Lithuania",45,1,2,0,3
25,2004,"Athens","EGY","Egypt",46,1,1,3,5
25,2004,"Athens","SUI","Switzerland",46,1,1,3,5
25,2004,"Athens","INA","Indonesia",48,1,1,2,4
25,2004,"Athens","ZIM","Zimbabwe",49,1,1,1,3
25,2004,"Athens","AZE","Azerbaijan",50,1,0,4,5
25,2004,"Athens","BEL","Belgium",51,1,0,2,3
25,2004,"Athens","BAH","Bahamas",52,1,0,1,2
25,2004,"Athens","ISR","Israel",52,1,0,1,2
25,2004,"Athens","CMR","Cameroon",54,1,0,0,1
25,2004,"Athens","DOM","Dominican Republic",54,1,0,0,1
25,2004,"Athens","UAE","United Arab Emirates",54,1,0,0,1
25,2004,"Athens","PRK","North Korea",57,0,4,1,5
25,2004,"Athens","LAT","Latvia",58,0,4,0,4
25,2004,"Athens","MEX","Mexico",59,0,3,1,4
25,2004,"Athens","POR","Portugal",60,0,2,1,3
25,2004,"Athens","FIN","Finland",61,0,2,0,2
25,2004,"Athens","SCG","Serbia and Montenegro",61,0,2,0,2
25,2004,"Athens","SLO","Slovenia",63,0,1,3,4
25,2004,"Athens","EST","Estonia",64,0,1,2,3
25,2004,"Athens","HKG","Hong Kong",65,0,1,0,1
25,2004,"Athens","IND","India",65,0,1,0,1
25,2004,"Athens","PAR","Paraguay",65,0,1,0,1
25,2004,"Athens","COL","Colombia",68,0,0,2,2
25,2004,"Athens","NGR","Nigeria",68,0,0,2,2
25,2004,"Athens","VEN","Venezuela",68,0,0,2,2
25,2004,"Athens","ERI","Eritrea",71,0,0,1,1
25,2004,"Athens","MGL","Mongolia",71,0,0,1,1
25,2004,"Athens","SYR","Syria",71,0,0,1,1
25,2004,"Athens","TRI","Trinidad and Tobago",71,0,0,1,1
24,2000,"Sydney","USA","United States",1,37,24,33,94
24,2000,"Sydney","RUS","Russia",2,32,28,29,89
24,2000,"Sydney","CHN","China",3,28,16,14,58
24,2000,"Sydney","AUS","Australia",4,16,25,17,58
24,2000,"Sydney","GER","Germany",5,13,17,26,56
24,2000,"Sydney","FRA","France",6,13,14,11,38
24,2000,"Sydney","ITA","Italy",7,13,8,13,34
24,2000,"Sydney","NED","Netherlands",8,12,9,4,25
24,2000,"Sydney","CUB","Cuba",9,11,11,7,29
24,2000,"Sydney","GBR","Great Britain",10,11,10,7,28
24,2000,"Sydney","ROU","Romania",11,11,6,9,26
24,2000,"Sydney","KOR","South Korea",12,8,10,10,28
24,2000,"Sydney","HUN","Hungary",13,8,6,3,17
24,2000,"Sydney","POL","Poland",14,6,5,3,14
24,2000,"Sydney","JPN","Japan",15,5,8,5,18
24,2000,"Sydney","BUL","Bulgaria",16,5,6,2,13
24,2000,"Sydney","GRE","Greece",17,4,6,3,13
24,2000,"Sydney","SWE","Sweden",18,4,5,3,12
24,2000,"Sydney","NOR","Norway",19,4,3,3,10
24,2000,"Sydney","ETH","Ethiopia",20,4,1,3,8
24,2000,"Sydney","UKR","Ukraine",21,3,10,10,23
24,2000,"Sydney","KAZ","Kazakhstan",22,3,4,0,7
24,2000,"Sydney","BLR","Belarus",23,3,3,11,17
24,2000,"Sydney","CAN","Canada",24,3,3,8,14
24,2000,"Sydney","ESP","Spain",25,3,3,5,11
24,2000,"Sydney","TUR","Turkey",26,3,0,2,5
24,2000,"Sydney","IRI","Iran",27,3,0,1,4
24,2000,"Sydney","CZE","Czech Republic",28,2,3,3,8
24,2000,"Sydney","KEN","Kenya",29,2,3,2,7
24,2000,"Sydney","DEN","Denmark",30,2,3,1,6
24,2000,"Sydney","FIN","Finland",31,2,1,1,4
24,2000,"Sydney","AUT","Austria",32,2,1,0,3
24,2000,"Sydney","LTU","Lithuania",33,2,0,3,5
24,2000,"Sydney","AZE","Azerbaijan",34,2,0,1,3
24,2000,"Sydney","SLO","Slovenia",35,2,0,0,2
24,2000,"Sydney","BAH","Bahamas",35,2,0,0,2
24,2000,"Sydney","SUI","Switzerland",37,1,6,2,9
24,2000,"Sydney","INA","Indonesia",38,1,3,2,6
24,2000,"Sydney","SVK","Slovakia",39,1,3,1,5
24,2000,"Sydney","MEX","Mexico",40,1,2,3,6
24,2000,"Sydney","ALG","Algeria",41,1,1,3,5
24,2000,"Sydney","UZB","Uzbekistan",42,1,1,2,4
24,2000,"Sydney","LAT","Latvia",43,1,1,1,3
24,2000,"Sydney","YUG","Yugoslavia",43,1,1,1,3
24,2000,"Sydney","NZL","New Zealand",45,1,0,3,4
24,2000,"Sydney","EST","Estonia",46,1,0,2,3
24,2000,"Sydney","THA","Thailand",46,1,0,2,3
24,2000,"Sydney","CRO","Croatia",48,1,0,1,2
24,2000,"Sydney","CMR","Cameroon",49,1,0,0,1
24,2000,"Sydney","COL","Colombia",49,1,0,0,1
24,2000,"Sydney","MOZ","Mozambique",49,1,0,0,1
24,2000,"Sydney","BRA","Brazil",52,0,6,6,12
24,2000,"Sydney","JAM","Jamaica",53,0,5,4,9
24,2000,"Sydney","NGR","Nigeria",54,0,3,0,3
24,2000,"Sydney","BEL","Belgium",55,0,2,3,5
24,2000,"Sydney","RSA","South Africa",55,0,2,3,5
24,2000,"Sydney","ARG","Argentina",57,0,2,2,4
24,2000,"Sydney","TPE","Chinese Taipei",58,0,1,4,5
24,2000,"Sydney","MAR","Morocco",58,0,1,4,5
24,2000,"Sydney","PRK","North Korea",60,0,1,3,4
24,2000,"Sydney","MDA","Moldova",61,0,1,1,2
24,2000,"Sydney","KSA","Saudi Arabia",61,0,1,1,2
24,2000,"Sydney","TRI","Trinidad and Tobago",61,0,1,1,2
24,2000,"Sydney","IRL","Ireland",64,0,1,0,1
24,2000,"Sydney","URU","Uruguay",64,0,1,0,1
24,2000,"Sydney","VIE","Vietnam",64,0,1,0,1
24,2000,"Sydney","SRI","Sri Lanka",64,0,1,0,1
24,2000,"Sydney","GEO","Georgia",68,0,0,6,6
24,2000,"Sydney","CRC","Costa Rica",69,0,0,2,2
24,2000,"Sydney","POR","Portugal",69,0,0,2,2
24,2000,"Sydney","ARM","Armenia",71,0,0,1,1
24,2000,"Sydney","BAR","Barbados",71,0,0,1,1
24,2000,"Sydney","CHI","Chile",71,0,0,1,1
24,2000,"Sydney","ISL","Iceland",71,0,0,1,1
24,2000,"Sydney","IND","India",71,0,0,1,1
24,2000,"Sydney","ISR","Israel",71,0,0,1,1
24,2000,"Sydney","KUW","Kuwait",71,0,0,1,1
24,2000,"Sydney","KGZ","Kyrgyzstan",71,0,0,1,1
24,2000,"Sydney","MKD","Macedonia",71,0,0,1,1
24,2000,"Sydney","QAT","Qatar",71,0,0,1,1
23,1996,"Atlanta","USA","United States",1,44,32,25,101
23,1996,"Atlanta","RUS","Russia",2,26,21,16,63
23,1996,"Atlanta","GER","Germany",3,20,18,27,65
23,1996,"Atlanta","CHN","China",4,16,22,12,50
23,1996,"Atlanta","FRA","France",5,15,7,15,37
23,1996,"Atlanta","ITA","Italy",6,13,10,12,35
23,1996,"Atlanta","AUS","Australia",7,9,9,23,41
23,1996,"Atlanta","CUB","Cuba",8,9,8,8,25
23,1996,"Atlanta","UKR","Ukraine",9,9,2,12,23
23,1996,"Atlanta","KOR","South Korea",10,7,15,5,27
23,1996,"Atlanta","POL","Poland",11,7,5,5,17
23,1996,"Atlanta","HUN","Hungary",12,7,4,10,21
23,1996,"Atlanta","ESP","Spain",13,5,6,6,17
23,1996,"Atlanta","ROU","Romania",14,4,7,9,20
23,1996,"Atlanta","NED","Netherlands",15,4,5,10,19
23,1996,"Atlanta","GRE","Greece",16,4,4,0,8
23,1996,"Atlanta","CZE","Czech Republic",17,4,3,4,11
23,1996,"Atlanta","SUI","Switzerland",18,4,3,0,7
23,1996,"Atlanta","DEN","Denmark",19,4,1,1,6
23,1996,"Atlanta","TUR","Turkey",19,4,1,1,6
23,1996,"Atlanta","CAN","Canada",21,3,11,8,22
23,1996,"Atlanta","BUL","Bulgaria",22,3,7,5,15
23,1996,"Atlanta","JPN","Japan",23,3,6,5,14
23,1996,"Atlanta","KAZ","Kazakhstan",24,3,4,4,11
23,1996,"Atlanta","BRA","Brazil",25,3,3,9,15
23,1996,"Atlanta","NZL","New Zealand",26,3,2,1,6
23,1996,"Atlanta","RSA","South Africa",27,3,1,1,5
23,1996,"Atlanta","IRL","Ireland",28,3,0,1,4
23,1996,"Atlanta","SWE","Sweden",29,2,4,2,8
23,1996,"Atlanta","NOR","Norway",30,2,2,3,7
23,1996,"Atlanta","BEL","Belgium",31,2,2,2,6
23,1996,"Atlanta","NGR","Nigeria",32,2,1,3,6
23,1996,"Atlanta","PRK","North Korea",33,2,1,2,5
23,1996,"Atlanta","ALG","Algeria",34,2,0,1,3
23,1996,"Atlanta","ETH","Ethiopia",34,2,0,1,3
23,1996,"Atlanta","GBR","Great Britain",36,1,8,6,15
23,1996,"Atlanta","BLR","Belarus",37,1,6,8,15
23,1996,"Atlanta","KEN","Kenya",38,1,4,3,8
23,1996,"Atlanta","JAM","Jamaica",39,1,3,2,6
23,1996,"Atlanta","FIN","Finland",40,1,2,1,4
23,1996,"Atlanta","INA","Indonesia",41,1,1,2,4
23,1996,"Atlanta","YUG","Yugoslavia",41,1,1,2,4
23,1996,"Atlanta","IRI","Iran",43,1,1,1,3
23,1996,"Atlanta","SVK","Slovakia",43,1,1,1,3
23,1996,"Atlanta","ARM","Armenia",45,1,1,0,2
23,1996,"Atlanta","CRO","Croatia",45,1,1,0,2
23,1996,"Atlanta","POR","Portugal",47,1,0,1,2
23,1996,"Atlanta","THA","Thailand",47,1,0,1,2
23,1996,"Atlanta","BDI","Burundi",49,1,0,0,1
23,1996,"Atlanta","CRC","Costa Rica",49,1,0,0,1
23,1996,"Atlanta","ECU","Ecuador",49,1,0,0,1
23,1996,"Atlanta","HKG","Hong Kong",49,1,0,0,1
23,1996,"Atlanta","SYR","Syria",49,1,0,0,1
23,1996,"Atlanta","ARG","Argentina",54,0,2,1,3
23,1996,"Atlanta","NAM","Namibia",55,0,2,0,2
23,1996,"Atlanta","SLO","Slovenia",55,0,2,0,2
23,1996,"Atlanta","AUT","Austria",57,0,1,2,3
23,1996,"Atlanta","MAS","Malaysia",58,0,1,1,2
23,1996,"Atlanta","MDA","Moldova",58,0,1,1,2
23,1996,"Atlanta","UZB","Uzbekistan",58,0,1,1,2
23,1996,"Atlanta","AZE","Azerbaijan",61,0,1,0,1
23,1996,"Atlanta","BAH","Bahamas",61,0,1,0,1
23,1996,"Atlanta","TPE","Chinese Taipei",61,0,1,0,1
23,1996,"Atlanta","LAT","Latvia",61,0,1,0,1
23,1996,"Atlanta","PHI","Philippines",61,0,1,0,1
23,1996,"Atlanta","TGA","Tonga",61,0,1,0,1
23,1996,"Atlanta","ZAM","Zambia",61,0,1,0,1
23,1996,"Atlanta","GEO","Georgia",68,0,0,2,2
23,1996,"Atlanta","MAR","Morocco",68,0,0,2,2
23,1996,"Atlanta","TRI","Trinidad and Tobago",68,0,0,2,2
23,1996,"Atlanta","IND","India",71,0,0,1,1
23,1996,"Atlanta","ISR","Israel",71,0,0,1,1
23,1996,"Atlanta","LTU","Lithuania",71,0,0,1,1
23,1996,"Atlanta","MEX","Mexico",71,0,0,1,1
23,1996,"Atlanta","MGL","Mongolia",71,0,0,1,1
23,1996,"Atlanta","MOZ","Mozambique",71,0,0,1,1
23,1996,"Atlanta","PUR","Puerto Rico",71,0,0,1,1
23,1996,"Atlanta","TUN","Tunisia",71,0,0,1,1
23,1996,"Atlanta","UGA","Uganda",71,0,0,1,1
22,1992,"Barcelona","EUN","Unified Team",1,45,38,29,112
22,1992,"Barcelona","USA","United States",2,37,34,37,108
22,1992,"Barcelona","GER","Germany",3,33,21,28,82
22,1992,"Barcelona","CHN","China",4,16,22,16,54
22,1992,"Barcelona","CUB","Cuba",5,14,6,11,31
22,1992,"Barcelona","ESP","Spain",6,13,7,2,22
22,1992,"Barcelona","KOR","South Korea",7,12,5,12,29
22,1992,"Barcelona","HUN","Hungary",8,11,12,7,30
22,1992,"Barcelona","FRA","France",9,8,5,16,29
22,1992,"Barcelona","AUS","Australia",10,7,9,11,27
22,1992,"Barcelona","CAN","Canada",11,7,4,7,18
22,1992,"Barcelona","ITA","Italy",12,6,5,8,19
22,1992,"Barcelona","GBR","Great Britain",13,5,3,12,20
22,1992,"Barcelona","ROU","Romania",14,4,6,8,18
22,1992,"Barcelona","TCH","Czechoslovakia",15,4,2,1,7
22,1992,"Barcelona","PRK","North Korea",16,4,0,5,9
22,1992,"Barcelona","JPN","Japan",17,3,8,11,22
22,1992,"Barcelona","BUL","Bulgaria",18,3,7,6,16
22,1992,"Barcelona","POL","Poland",19,3,6,10,19
22,1992,"Barcelona","NED","Netherlands",20,2,6,7,15
22,1992,"Barcelona","KEN","Kenya",21,2,4,2,8
22,1992,"Barcelona","NOR","Norway",22,2,4,1,7
22,1992,"Barcelona","TUR","Turkey",23,2,2,2,6
22,1992,"Barcelona","INA","Indonesia",24,2,2,1,5
22,1992,"Barcelona","BRA","Brazil",25,2,1,0,3
22,1992,"Barcelona","GRE","Greece",26,2,0,0,2
22,1992,"Barcelona","SWE","Sweden",27,1,7,4,12
22,1992,"Barcelona","NZL","New Zealand",28,1,4,5,10
22,1992,"Barcelona","FIN","Finland",29,1,2,2,5
22,1992,"Barcelona","DEN","Denmark",30,1,1,4,6
22,1992,"Barcelona","MAR","Morocco",31,1,1,1,3
22,1992,"Barcelona","IRL","Ireland",32,1,1,0,2
22,1992,"Barcelona","ETH","Ethiopia",33,1,0,2,3
22,1992,"Barcelona","ALG","Algeria",34,1,0,1,2
22,1992,"Barcelona","EST","Estonia",34,1,0,1,2
22,1992,"Barcelona","LTU","Lithuania",34,1,0,1,2
22,1992,"Barcelona","SUI","Switzerland",37,1,0,0,1
22,1992,"Barcelona","JAM","Jamaica",38,0,3,1,4
22,1992,"Barcelona","NGR","Nigeria",38,0,3,1,4
22,1992,"Barcelona","LAT","Latvia",40,0,2,1,3
22,1992,"Barcelona","AUT","Austria",41,0,2,0,2
22,1992,"Barcelona","NAM","Namibia",41,0,2,0,2
22,1992,"Barcelona","RSA","South Africa",41,0,2,0,2
22,1992,"Barcelona","BEL","Belgium",44,0,1,2,3
22,1992,"Barcelona","CRO","Croatia",44,0,1,2,3
22,1992,"Barcelona","IOP","Independent Olympic Participants",44,0,1,2,3
22,1992,"Barcelona","IRI","Iran",44,0,1,2,3
22,1992,"Barcelona","ISR","Israel",48,0,1,1,2
22,1992,"Barcelona","TPE","Chinese Taipei",49,0,1,0,1
22,1992,"Barcelona","MEX","Mexico",49,0,1,0,1
22,1992,"Barcelona","PER","Peru",49,0,1,0,1
22,1992,"Barcelona","MGL","Mongolia",52,0,0,2,2
22,1992,"Barcelona","SLO","Slovenia",52,0,0,2,2
22,1992,"Barcelona","ARG","Argentina",54,0,0,1,1
22,1992,"Barcelona","BAH","Bahamas",54,0,0,1,1
22,1992,"Barcelona","COL","Colombia",54,0,0,1,1
22,1992,"Barcelona","GHA","Ghana",54,0,0,1,1
22,1992,"Barcelona","MAS","Malaysia",54,0,0,1,1
22,1992,"Barcelona","PAK","Pakistan",54,0,0,1,1
22,1992,"Barcelona","PHI","Philippines",54,0,0,1,1
22,1992,"Barcelona","PUR","Puerto Rico",54,0,0,1,1
22,1992,"Barcelona","QAT","Qatar",54,0,0,1,1
22,1992,"Barcelona","SUR","Suriname",54,0,0,1,1
22,1992,"Barcelona","THA","Thailand",54,0,0,1,1
21,1988,"Seoul","URS","Soviet Union",1,55,31,46,132
21,1988,"Seoul","GDR","East Germany",2,37,35,30,102
21,1988,"Seoul","USA","United States",3,36,31,27,94
21,1988,"Seoul","KOR","South Korea",4,12,10,11,33
21,1988,"Seoul","FRG","West Germany",5,11,14,15,40
21,1988,"Seoul","HUN","Hungary",6,11,6,6,23
21,1988,"Seoul","BUL","Bulgaria",7,10,12,13,35
21,1988,"Seoul","ROU","Romania",8,7,11,6,24
21,1988,"Seoul","FRA","France",9,6,4,6,16
21,1988,"Seoul","ITA","Italy",10,6,4,4,14
21,1988,"Seoul","CHN","China",11,5,11,12,28
21,1988,"Seoul","GBR","Great Britain",12,5,10,9,24
21,1988,"Seoul","KEN","Kenya",13,5,2,2,9
21,1988,"Seoul","JPN","Japan",14,4,3,7,14
21,1988,"Seoul","AUS","Australia",15,3,6,5,14
21,1988,"Seoul","YUG","Yugoslavia",16,3,4,5,12
21,1988,"Seoul","TCH","Czechoslovakia",17,3,3,2,8
21,1988,"Seoul","NZL","New Zealand",18,3,2,8,13
21,1988,"Seoul","CAN","Canada",19,3,2,5,10
21,1988,"Seoul","POL","Poland",20,2,5,9,16
21,1988,"Seoul","NOR","Norway",21,2,3,0,5
21,1988,"Seoul","NED","Netherlands",22,2,2,5,9
21,1988,"Seoul","DEN","Denmark",23,2,1,1,4
21,1988,"Seoul","BRA","Brazil",24,1,2,3,6
21,1988,"Seoul","FIN","Finland",25,1,1,2,4
21,1988,"Seoul","ESP","Spain",25,1,1,2,4
21,1988,"Seoul","TUR","Turkey",27,1,1,0,2
21,1988,"Seoul","MAR","Morocco",28,1,0,2,3
21,1988,"Seoul","AUT","Austria",29,1,0,0,1
21,1988,"Seoul","POR","Portugal",29,1,0,0,1
21,1988,"Seoul","SUR","Suriname",29,1,0,0,1
21,1988,"Seoul","SWE","Sweden",32,0,4,7,11
21,1988,"Seoul","SUI","Switzerland",33,0,2,2,4
21,1988,"Seoul","JAM","Jamaica",34,0,2,0,2
21,1988,"Seoul","ARG","Argentina",35,0,1,1,2
21,1988,"Seoul","CHI","Chile",36,0,1,0,1
21,1988,"Seoul","CRC","Costa Rica",36,0,1,0,1
21,1988,"Seoul","INA","Indonesia",36,0,1,0,1
21,1988,"Seoul","IRI","Iran",36,0,1,0,1
21,1988,"Seoul","AHO","Netherlands Antilles",36,0,1,0,1
21,1988,"Seoul","PER","Peru",36,0,1,0,1
21,1988,"Seoul","SEN","Senegal",36,0,1,0,1
21,1988,"Seoul","ISV","Virgin Islands",36,0,1,0,1
21,1988,"Seoul","BEL","Belgium",44,0,0,2,2
21,1988,"Seoul","MEX","Mexico",44,0,0,2,2
21,1988,"Seoul","COL","Colombia",46,0,0,1,1
21,1988,"Seoul","DJI","Djibouti",46,0,0,1,1
21,1988,"Seoul","GRE","Greece",46,0,0,1,1
21,1988,"Seoul","MGL","Mongolia",46,0,0,1,1
21,1988,"Seoul","PAK","Pakistan",46,0,0,1,1
21,1988,"Seoul","PHI","Philippines",46,0,0,1,1
21,1988,"Seoul","THA","Thailand",46,0,0,1,1
20,1984,"Los Angeles","USA","United States",1,83,61,30,174
20,1984,"Los Angeles","ROU","Romania",2,20,16,17,53
20,1984,"Los Angeles","FRG","West Germany",3,17,19,23,59
20,1984,"Los Angeles","CHN","China",4,15,8,9,32
20,1984,"Los Angeles","ITA","Italy",5,14,6,12,32
20,1984,"Los Angeles","CAN","Canada",6,10,18,16,44
20,1984,"Los Angeles","JPN","Japan",7,10,8,14,32
20,1984,"Los Angeles","NZL","New Zealand",8,8,1,2,11
20,1984,"Los Angeles","YUG","Yugoslavia",9,7,4,7,18
20,1984,"Los Angeles","KOR","South Korea",10,6,6,7,19
20,1984,"Los Angeles","GBR","Great Britain",11,5,11,21,37
20,1984,"Los Angeles","FRA","France",12,5,7,16,28
20,1984,"Los Angeles","NED","Netherlands",13,5,2,6,13
20,1984,"Los Angeles","AUS","Australia",14,4,8,12,24
20,1984,"Los Angeles","FIN","Finland",15,4,2,6,12
20,1984,"Los Angeles","SWE","Sweden",16,2,11,6,19
20,1984,"Los Angeles","MEX","Mexico",17,2,3,1,6
20,1984,"Los Angeles","MAR","Morocco",18,2,0,0,2
20,1984,"Los Angeles","BRA","Brazil",19,1,5,2,8
20,1984,"Los Angeles","ESP","Spain",20,1,2,2,5
20,1984,"Los Angeles","BEL","Belgium",21,1,1,2,4
20,1984,"Los Angeles","AUT","Austria",22,1,1,1,3
20,1984,"Los Angeles","KEN","Kenya",23,1,0,2,3
20,1984,"Los Angeles","POR","Portugal",23,1,0,2,3
20,1984,"Los Angeles","PAK","Pakistan",25,1,0,0,1
20,1984,"Los Angeles","SUI","Switzerland",26,0,4,4,8
20,1984,"Los Angeles","DEN","Denmark",27,0,3,3,6
20,1984,"Los Angeles","JAM","Jamaica",28,0,1,2,3
20,1984,"Los Angeles","NOR","Norway",28,0,1,2,3
20,1984,"Los Angeles","GRE","Greece",30,0,1,1,2
20,1984,"Los Angeles","NGR","Nigeria",30,0,1,1,2
20,1984,"Los Angeles","PUR","Puerto Rico",30,0,1,1,2
20,1984,"Los Angeles","COL","Colombia",33,0,1,0,1
20,1984,"Los Angeles","CIV","Côte d'Ivoire",33,0,1,0,1
20,1984,"Los Angeles","EGY","Egypt",33,0,1,0,1
20,1984,"Los Angeles","IRL","Ireland",33,0,1,0,1
20,1984,"Los Angeles","PER","Peru",33,0,1,0,1
20,1984,"Los Angeles","SYR","Syria",33,0,1,0,1
20,1984,"Los Angeles","THA","Thailand",33,0,1,0,1
20,1984,"Los Angeles","TUR","Turkey",40,0,0,3,3
20,1984,"Los Angeles","VEN","Venezuela",40,0,0,3,3
20,1984,"Los Angeles","ALG","Algeria",42,0,0,2,2
20,1984,"Los Angeles","CMR","Cameroon",43,0,0,1,1
20,1984,"Los Angeles","TPE","Chinese Taipei",43,0,0,1,1
20,1984,"Los Angeles","DOM","Dominican Republic",43,0,0,1,1
20,1984,"Los Angeles","ISL","Iceland",43,0,0,1,1
20,1984,"Los Angeles","ZAM","Zambia",43,0,0,1,1
19,1980,"Moscow","URS","Soviet Union",1,80,69,46,195
19,1980,"Moscow","GDR","East Germany",2,47,37,42,126
19,1980,"Moscow","BUL","Bulgaria",3,8,16,17,41
19,1980,"Moscow","CUB","Cuba",4,8,7,5,20
19,1980,"Moscow","ITA","Italy",5,8,3,4,15
19,1980,"Moscow","HUN","Hungary",6,7,10,15,32
19,1980,"Moscow","ROU","Romania",7,6,6,13,25
19,1980,"Moscow","FRA","France",8,6,5,3,14
19,1980,"Moscow","GBR","Great Britain",9,5,7,9,21
19,1980,"Moscow","POL","Poland",10,3,14,15,32
19,1980,"Moscow","SWE","Sweden",11,3,3,6,12
19,1980,"Moscow","FIN","Finland",12,3,1,4,8
19,1980,"Moscow","TCH","Czechoslovakia",13,2,3,9,14
19,1980,"Moscow","YUG","Yugoslavia",14,2,3,4,9
19,1980,"Moscow","AUS","Australia",15,2,2,5,9
19,1980,"Moscow","DEN","Denmark",16,2,1,2,5
19,1980,"Moscow","BRA","Brazil",17,2,0,2,4
19,1980,"Moscow","ETH","Ethiopia",17,2,0,2,4
19,1980,"Moscow","SUI","Switzerland",19,2,0,0,2
19,1980,"Moscow","ESP","Spain",20,1,3,2,6
19,1980,"Moscow","AUT","Austria",21,1,2,1,4
19,1980,"Moscow","GRE","Greece",22,1,0,2,3
19,1980,"Moscow","BEL","Belgium",23,1,0,0,1
19,1980,"Moscow","IND","India",23,1,0,0,1
19,1980,"Moscow","ZIM","Zimbabwe",23,1,0,0,1
19,1980,"Moscow","PRK","North Korea",26,0,3,2,5
19,1980,"Moscow","MGL","Mongolia",27,0,2,2,4
19,1980,"Moscow","TAN","Tanzania",28,0,2,0,2
19,1980,"Moscow","MEX","Mexico",29,0,1,3,4
19,1980,"Moscow","NED","Netherlands",30,0,1,2,3
19,1980,"Moscow","IRL","Ireland",31,0,1,1,2
19,1980,"Moscow","UGA","Uganda",32,0,1,0,1
19,1980,"Moscow","VEN","Venezuela",32,0,1,0,1
19,1980,"Moscow","JAM","Jamaica",34,0,0,3,3
19,1980,"Moscow","GUY","Guyana",35,0,0,1,1
19,1980,"Moscow","LIB","Lebanon",35,0,0,1,1
18,1976,"Montreal","URS","Soviet Union",1,49,41,35,125
18,1976,"Montreal","GDR","East Germany",2,40,25,25,90
18,1976,"Montreal","USA","United States",3,34,35,25,94
18,1976,"Montreal","FRG","West Germany",4,10,12,17,39
18,1976,"Montreal","JPN","Japan",5,9,6,10,25
18,1976,"Montreal","POL","Poland",6,7,6,13,26
18,1976,"Montreal","BUL","Bulgaria",7,6,9,7,22
18,1976,"Montreal","CUB","Cuba",8,6,4,3,13
18,1976,"Montreal","ROU","Romania",9,4,9,14,27
18,1976,"Montreal","HUN","Hungary",10,4,5,13,22
18,1976,"Montreal","FIN","Finland",11,4,2,0,6
18,1976,"Montreal","SWE","Sweden",12,4,1,0,5
18,1976,"Montreal","GBR","Great Britain",13,3,5,5,13
18,1976,"Montreal","ITA","Italy",14,2,7,4,13
18,1976,"Montreal","FRA","France",15,2,3,4,9
18,1976,"Montreal","YUG","Yugoslavia",16,2,3,3,8
18,1976,"Montreal","TCH","Czechoslovakia",17,2,2,4,8
18,1976,"Montreal","NZL","New Zealand",18,2,1,1,4
18,1976,"Montreal","KOR","South Korea",19,1,1,4,6
18,1976,"Montreal","SUI","Switzerland",20,1,1,2,4
18,1976,"Montreal","JAM","Jamaica",21,1,1,0,2
18,1976,"Montreal","PRK","North Korea",21,1,1,0,2
18,1976,"Montreal","NOR","Norway",21,1,1,0,2
18,1976,"Montreal","DEN","Denmark",24,1,0,2,3
18,1976,"Montreal","MEX","Mexico",25,1,0,1,2
18,1976,"Montreal","TRI","Trinidad and Tobago",26,1,0,0,1
18,1976,"Montreal","CAN","Canada",27,0,5,6,11
18,1976,"Montreal","BEL","Belgium",28,0,3,3,6
18,1976,"Montreal","NED","Netherlands",29,0,2,3,5
18,1976,"Montreal","POR","Portugal",30,0,2,0,2
18,1976,"Montreal","ESP","Spain",30,0,2,0,2
18,1976,"Montreal","AUS","Australia",32,0,1,4,5
18,1976,"Montreal","IRI","Iran",33,0,1,1,2
18,1976,"Montreal","MGL","Mongolia",34,0,1,0,1
18,1976,"Montreal","VEN","Venezuela",34,0,1,0,1
18,1976,"Montreal","BRA","Brazil",36,0,0,2,2
18,1976,"Montreal","AUT","Austria",37,0,0,1,1
18,1976,"Montreal","BER","Bermuda",37,0,0,1,1
18,1976,"Montreal","PAK","Pakistan",37,0,0,1,1
18,1976,"Montreal","PUR","Puerto Rico",37,0,0,1,1
18,1976,"Montreal","THA","Thailand",37,0,0,1,1
17,1972,"Munich","URS","Soviet Union",1,50,27,22,99
17,1972,"Munich","USA","United States",2,33,31,30,94
17,1972,"Munich","GDR","East Germany",3,20,23,23,66
17,1972,"Munich","FRG","West Germany",4,13,11,16,40
17,1972,"Munich","JPN","Japan",5,13,8,8,29
17,1972,"Munich","AUS","Australia",6,8,7,2,17
17,1972,"Munich","POL","Poland",7,7,5,9,21
17,1972,"Munich","HUN","Hungary",8,6,13,16,35
17,1972,"Munich","BUL","Bulgaria",9,6,10,5,21
17,1972,"Munich","ITA","Italy",10,5,3,10,18
17,1972,"Munich","SWE","Sweden",11,4,6,6,16
17,1972,"Munich","GBR","Great Britain",12,4,5,9,18
17,1972,"Munich","ROU","Romania",13,3,6,7,16
17,1972,"Munich","CUB","Cuba",14,3,1,4,8
17,1972,"Munich","FIN","Finland",14,3,1,4,8
17,1972,"Munich","NED","Netherlands",16,3,1,1,5
17,1972,"Munich","FRA","France",17,2,4,7,13
17,1972,"Munich","TCH","Czechoslovakia",18,2,4,2,8
17,1972,"Munich","KEN","Kenya",19,2,3,4,9
17,1972,"Munich","YUG","Yugoslavia",20,2,1,2,5
17,1972,"Munich","NOR","Norway",21,2,1,1,4
17,1972,"Munich","PRK","North Korea",22,1,1,3,5
17,1972,"Munich","NZL","New Zealand",23,1,1,1,3
17,1972,"Munich","UGA","Uganda",24,1,1,0,2
17,1972,"Munich","DEN","Denmark",25,1,0,0,1
17,1972,"Munich","SUI","Switzerland",26,0,3,0,3
17,1972,"Munich","CAN","Canada",27,0,2,3,5
17,1972,"Munich","IRI","Iran",28,0,2,1,3
17,1972,"Munich","BEL","Belgium",29,0,2,0,2
17,1972,"Munich","GRE","Greece",29,0,2,0,2
17,1972,"Munich","AUT","Austria",31,0,1,2,3
17,1972,"Munich","COL","Colombia",31,0,1,2,3
17,1972,"Munich","ARG","Argentina",33,0,1,0,1
17,1972,"Munich","KOR","South Korea",33,0,1,0,1
17,1972,"Munich","LIB","Lebanon",33,0,1,0,1
17,1972,"Munich","MEX","Mexico",33,0,1,0,1
17,1972,"Munich","MGL","Mongolia",33,0,1,0,1
17,1972,"Munich","PAK","Pakistan",33,0,1,0,1
17,1972,"Munich","TUN","Tunisia",33,0,1,0,1
17,1972,"Munich","TUR","Turkey",33,0,1,0,1
17,1972,"Munich","BRA","Brazil",41,0,0,2,2
17,1972,"Munich","ETH","Ethiopia",41,0,0,2,2
17,1972,"Munich","GHA","Ghana",43,0,0,1,1
17,1972,"Munich","IND","India",43,0,0,1,1
17,1972,"Munich","JAM","Jamaica",43,0,0,1,1
17,1972,"Munich","NIG","Niger",43,0,0,1,1
17,1972,"Munich","NGR","Nigeria",43,0,0,1,1
17,1972,"Munich","ESP","Spain",43,0,0,1,1
16,1968,"Mexico","USA","United States",1,45,28,34,107
16,1968,"Mexico","URS","Soviet Union",2,29,32,30,91
16,1968,"Mexico","JPN","Japan",3,11,7,7,25
16,1968,"Mexico","HUN","Hungary",4,10,10,12,32
16,1968,"Mexico","GDR","East Germany",5,9,9,7,25
16,1968,"Mexico","FRA","France",6,7,3,5,15
16,1968,"Mexico","TCH","Czechoslovakia",7,7,2,4,13
16,1968,"Mexico","FRG","West Germany",8,5,11,10,26
16,1968,"Mexico","AUS","Australia",9,5,7,5,17
16,1968,"Mexico","GBR","Great Britain",10,5,5,3,13
16,1968,"Mexico","POL","Poland",11,5,2,11,18
16,1968,"Mexico","ROU","Romania",12,4,6,5,15
16,1968,"Mexico","ITA","Italy",13,3,4,9,16
16,1968,"Mexico","KEN","Kenya",14,3,4,2,9
16,1968,"Mexico","MEX","Mexico",15,3,3,3,9
16,1968,"Mexico","YUG","Yugoslavia",16,3,3,2,8
16,1968,"Mexico","NED","Netherlands",17,3,3,1,7
16,1968,"Mexico","BUL","Bulgaria",18,2,4,3,9
16,1968,"Mexico","IRI","Iran",19,2,1,2,5
16,1968,"Mexico","SWE","Sweden",20,2,1,1,4
16,1968,"Mexico","TUR","Turkey",21,2,0,0,2
16,1968,"Mexico","DEN","Denmark",22,1,4,3,8
16,1968,"Mexico","CAN","Canada",23,1,3,1,5
16,1968,"Mexico","FIN","Finland",24,1,2,1,4
16,1968,"Mexico","ETH","Ethiopia",25,1,1,0,2
16,1968,"Mexico","NOR","Norway",25,1,1,0,2
16,1968,"Mexico","NZL","New Zealand",27,1,0,2,3
16,1968,"Mexico","TUN","Tunisia",28,1,0,1,2
16,1968,"Mexico","PAK","Pakistan",29,1,0,0,1
16,1968,"Mexico","VEN","Venezuela",29,1,0,0,1
16,1968,"Mexico","CUB","Cuba",31,0,4,0,4
16,1968,"Mexico","AUT","Austria",32,0,2,2,4
16,1968,"Mexico","SUI","Switzerland",33,0,1,4,5
16,1968,"Mexico","MGL","Mongolia",34,0,1,3,4
16,1968,"Mexico","BRA","Brazil",35,0,1,2,3
16,1968,"Mexico","BEL","Belgium",36,0,1,1,2
16,1968,"Mexico","KOR","South Korea",36,0,1,1,2
16,1968,"Mexico","UGA","Uganda",36,0,1,1,2
16,1968,"Mexico","CMR","Cameroon",39,0,1,0,1
16,1968,"Mexico","JAM","Jamaica",39,0,1,0,1
16,1968,"Mexico","ARG","Argentina",41,0,0,2,2
16,1968,"Mexico","GRE","Greece",42,0,0,1,1
16,1968,"Mexico","IND","India",42,0,0,1,1
16,1968,"Mexico","ROC","Republic of China",42,0,0,1,1
15,1964,"Tokyo","USA","United States",1,36,26,28,90
15,1964,"Tokyo","URS","Soviet Union",2,30,31,35,96
15,1964,"Tokyo","JPN","Japan",3,16,5,8,29
15,1964,"Tokyo","EUA","Germany",4,10,22,18,50
15,1964,"Tokyo","ITA","Italy",5,10,10,7,27
15,1964,"Tokyo","HUN","Hungary",6,10,7,5,22
15,1964,"Tokyo","POL","Poland",7,7,6,10,23
15,1964,"Tokyo","AUS","Australia",8,6,2,10,18
15,1964,"Tokyo","TCH","Czechoslovakia",9,5,6,3,14
15,1964,"Tokyo","GBR","Great Britain",10,4,12,2,18
15,1964,"Tokyo","BUL","Bulgaria",11,3,5,2,10
15,1964,"Tokyo","FIN","Finland",12,3,0,2,5
15,1964,"Tokyo","NZL","New Zealand",12,3,0,2,5
15,1964,"Tokyo","ROU","Romania",14,2,4,6,12
15,1964,"Tokyo","NED","Netherlands",15,2,4,4,10
15,1964,"Tokyo","TUR","Turkey",16,2,3,1,6
15,1964,"Tokyo","SWE","Sweden",17,2,2,4,8
15,1964,"Tokyo","DEN","Denmark",18,2,1,3,6
15,1964,"Tokyo","YUG","Yugoslavia",19,2,1,2,5
15,1964,"Tokyo","BEL","Belgium",20,2,0,1,3
15,1964,"Tokyo","FRA","France",21,1,8,6,15
15,1964,"Tokyo","CAN","Canada",22,1,2,1,4
15,1964,"Tokyo","SUI","Switzerland",22,1,2,1,4
15,1964,"Tokyo","BAH","Bahamas",24,1,0,0,1
15,1964,"Tokyo","ETH","Ethiopia",24,1,0,0,1
15,1964,"Tokyo","IND","India",24,1,0,0,1
15,1964,"Tokyo","KOR","South Korea",27,0,2,1,3
15,1964,"Tokyo","TRI","Trinidad and Tobago",28,0,1,2,3
15,1964,"Tokyo","TUN","Tunisia",29,0,1,1,2
15,1964,"Tokyo","ARG","Argentina",30,0,1,0,1
15,1964,"Tokyo","CUB","Cuba",30,0,1,0,1
15,1964,"Tokyo","PAK","Pakistan",30,0,1,0,1
15,1964,"Tokyo","PHI","Philippines",30,0,1,0,1
15,1964,"Tokyo","IRI","Iran",34,0,0,2,2
15,1964,"Tokyo","BRA","Brazil",35,0,0,1,1
15,1964,"Tokyo","GHA","Ghana",35,0,0,1,1
15,1964,"Tokyo","IRL","Ireland",35,0,0,1,1
15,1964,"Tokyo","KEN","Kenya",35,0,0,1,1
15,1964,"Tokyo","MEX","Mexico",35,0,0,1,1
15,1964,"Tokyo","NGR","Nigeria",35,0,0,1,1
15,1964,"Tokyo","URU","Uruguay",35,0,0,1,1
14,1960,"Rome","URS","Soviet Union",1,43,29,31,103
14,1960,"Rome","USA","United States",2,34,21,16,71
14,1960,"Rome","ITA","Italy",3,13,10,13,36
14,1960,"Rome","EUA","Germany",4,12,19,11,42
14,1960,"Rome","AUS","Australia",5,8,8,6,22
14,1960,"Rome","TUR","Turkey",6,7,2,0,9
14,1960,"Rome","HUN","Hungary",7,6,8,7,21
14,1960,"Rome","JPN","Japan",8,4,7,7,18
14,1960,"Rome","POL","Poland",9,4,6,11,21
14,1960,"Rome","TCH","Czechoslovakia",10,3,2,3,8
14,1960,"Rome","ROU","Romania",11,3,1,6,10
14,1960,"Rome","GBR","Great Britain",12,2,6,12,20
14,1960,"Rome","DEN","Denmark",13,2,3,1,6
14,1960,"Rome","NZL","New Zealand",14,2,0,1,3
14,1960,"Rome","BUL","Bulgaria",15,1,3,3,7
14,1960,"Rome","SWE","Sweden",16,1,2,3,6
14,1960,"Rome","FIN","Finland",17,1,1,3,5
14,1960,"Rome","AUT","Austria",18,1,1,0,2
14,1960,"Rome","YUG","Yugoslavia",18,1,1,0,2
14,1960,"Rome","PAK","Pakistan",20,1,0,1,2
14,1960,"Rome","ETH","Ethiopia",21,1,0,0,1
14,1960,"Rome","GRE","Greece",21,1,0,0,1
14,1960,"Rome","NOR","Norway",21,1,0,0,1
14,1960,"Rome","SUI","Switzerland",24,0,3,3,6
14,1960,"Rome","FRA","France",25,0,2,3,5
14,1960,"Rome","BEL","Belgium",26,0,2,2,4
14,1960,"Rome","IRI","Iran",27,0,1,3,4
14,1960,"Rome","NED","Netherlands",28,0,1,2,3
14,1960,"Rome","RSA","South Africa",28,0,1,2,3
14,1960,"Rome","ARG","Argentina",30,0,1,1,2
14,1960,"Rome","EGY","United Arab Republic",30,0,1,1,2
14,1960,"Rome","CAN","Canada",32,0,1,0,1
14,1960,"Rome","ROC","Republic of China",32,0,1,0,1
14,1960,"Rome","GHA","Ghana",32,0,1,0,1
14,1960,"Rome","IND","India",32,0,1,0,1
14,1960,"Rome","MAR","Morocco",32,0,1,0,1
14,1960,"Rome","POR","Portugal",32,0,1,0,1
14,1960,"Rome","SIN","Singapore",32,0,1,0,1
14,1960,"Rome","BRA","Brazil",39,0,0,2,2
14,1960,"Rome","BWI","British West Indies",39,0,0,2,2
14,1960,"Rome","IRQ","Iraq",41,0,0,1,1
14,1960,"Rome","MEX","Mexico",41,0,0,1,1
14,1960,"Rome","ESP","Spain",41,0,0,1,1
14,1960,"Rome","VEN","Venezuela",41,0,0,1,1
13,1956,"Melbourne","URS","Soviet Union",1,37,29,32,98
13,1956,"Melbourne","USA","United States",2,32,25,17,74
13,1956,"Melbourne","AUS","Australia",3,13,8,14,35
13,1956,"Melbourne","HUN","Hungary",4,9,10,7,26
13,1956,"Melbourne","ITA","Italy",5,8,8,9,25
13,1956,"Melbourne","SWE","Sweden",6,8,5,6,19
13,1956,"Melbourne","EUA","Germany",7,6,13,7,26
13,1956,"Melbourne","GBR","Great Britain",8,6,7,11,24
13,1956,"Melbourne","ROU","Romania",9,5,3,5,13
13,1956,"Melbourne","JPN","Japan",10,4,10,5,19
13,1956,"Melbourne","FRA","France",11,4,4,6,14
13,1956,"Melbourne","TUR","Turkey",12,3,2,2,7
13,1956,"Melbourne","FIN","Finland",13,3,1,11,15
13,1956,"Melbourne","IRI","Iran",14,2,2,1,5
13,1956,"Melbourne","CAN","Canada",15,2,1,3,6
13,1956,"Melbourne","NZL","New Zealand",16,2,0,0,2
13,1956,"Melbourne","POL","Poland",17,1,4,4,9
13,1956,"Melbourne","TCH","Czechoslovakia",18,1,4,1,6
13,1956,"Melbourne","BUL","Bulgaria",19,1,3,1,5
13,1956,"Melbourne","DEN","Denmark",20,1,2,1,4
13,1956,"Melbourne","IRL","Ireland",21,1,1,3,5
13,1956,"Melbourne","NOR","Norway",22,1,0,2,3
13,1956,"Melbourne","MEX","Mexico",23,1,0,1,2
13,1956,"Melbourne","BRA","Brazil",24,1,0,0,1
13,1956,"Melbourne","IND","India",24,1,0,0,1
13,1956,"Melbourne","YUG","Yugoslavia",26,0,3,0,3
13,1956,"Melbourne","CHI","Chile",27,0,2,2,4
13,1956,"Melbourne","BEL","Belgium",28,0,2,0,2
13,1956,"Melbourne","ARG","Argentina",29,0,1,1,2
13,1956,"Melbourne","KOR","South Korea",29,0,1,1,2
13,1956,"Melbourne","ISL","Iceland",31,0,1,0,1
13,1956,"Melbourne","PAK","Pakistan",31,0,1,0,1
13,1956,"Melbourne","RSA","South Africa",33,0,0,4,4
13,1956,"Melbourne","AUT","Austria",34,0,0,2,2
13,1956,"Melbourne","BAH","Bahamas",35,0,0,1,1
13,1956,"Melbourne","GRE","Greece",35,0,0,1,1
13,1956,"Melbourne","SUI","Switzerland",35,0,0,1,1
13,1956,"Melbourne","URU","Uruguay",35,0,0,1,1
12,1952,"Helsinki","USA","United States",1,40,19,17,76
12,1952,"Helsinki","URS","Soviet Union",2,22,30,19,71
12,1952,"Helsinki","HUN","Hungary",3,16,10,16,42
12,1952,"Helsinki","SWE","Sweden",4,12,13,10,35
12,1952,"Helsinki","ITA","Italy",5,8,9,4,21
12,1952,"Helsinki","TCH","Czechoslovakia",6,7,3,3,13
12,1952,"Helsinki","FRA","France",7,6,6,6,18
12,1952,"Helsinki","FIN","Finland",8,6,3,13,22
12,1952,"Helsinki","AUS","Australia",9,6,2,3,11
12,1952,"Helsinki","NOR","Norway",10,3,2,0,5
12,1952,"Helsinki","SUI","Switzerland",11,2,6,6,14
12,1952,"Helsinki","RSA","South Africa",12,2,4,4,10
12,1952,"Helsinki","JAM","Jamaica",13,2,3,0,5
12,1952,"Helsinki","BEL","Belgium",14,2,2,0,4
12,1952,"Helsinki","DEN","Denmark",15,2,1,3,6
12,1952,"Helsinki","TUR","Turkey",16,2,0,1,3
12,1952,"Helsinki","JPN","Japan",17,1,6,2,9
12,1952,"Helsinki","GBR","Great Britain",18,1,2,8,11
12,1952,"Helsinki","ARG","Argentina",19,1,2,2,5
12,1952,"Helsinki","POL","Poland",20,1,2,1,4
12,1952,"Helsinki","CAN","Canada",21,1,2,0,3
12,1952,"Helsinki","YUG","Yugoslavia",21,1,2,0,3
12,1952,"Helsinki","ROU","Romania",23,1,1,2,4
12,1952,"Helsinki","BRA","Brazil",24,1,0,2,3
12,1952,"Helsinki","NZL","New Zealand",24,1,0,2,3
12,1952,"Helsinki","IND","India",26,1,0,1,2
12,1952,"Helsinki","LUX","Luxembourg",27,1,0,0,1
12,1952,"Helsinki","GER","Germany",28,0,7,17,24
12,1952,"Helsinki","NED","Netherlands",29,0,5,0,5
12,1952,"Helsinki","IRI","Iran",30,0,3,4,7
12,1952,"Helsinki","CHI","Chile",31,0,2,0,2
12,1952,"Helsinki","AUT","Austria",32,0,1,1,2
12,1952,"Helsinki","LIB","Lebanon",32,0,1,1,2
12,1952,"Helsinki","IRL","Ireland",34,0,1,0,1
12,1952,"Helsinki","MEX","Mexico",34,0,1,0,1
12,1952,"Helsinki","ESP","Spain",34,0,1,0,1
12,1952,"Helsinki","KOR","South Korea",37,0,0,2,2
12,1952,"Helsinki","TRI","Trinidad and Tobago",37,0,0,2,2
12,1952,"Helsinki","URU","Uruguay",37,0,0,2,2
12,1952,"Helsinki","BUL","Bulgaria",40,0,0,1,1
12,1952,"Helsinki","EGY","Egypt",40,0,0,1,1
12,1952,"Helsinki","POR","Portugal",40,0,0,1,1
12,1952,"Helsinki","VEN","Venezuela",40,0,0,1,1
11,1948,"London","USA","United States",1,38,27,19,84
11,1948,"London","SWE","Sweden",2,16,11,17,44
11,1948,"London","FRA","France",3,10,6,13,29
11,1948,"London","HUN","Hungary",4,10,5,12,27
11,1948,"London","ITA","Italy",5,8,11,8,27
11,1948,"London","FIN","Finland",6,8,7,5,20
11,1948,"London","TUR","Turkey",7,6,4,2,12
11,1948,"London","TCH","Czechoslovakia",8,6,2,3,11
11,1948,"London","SUI","Switzerland",9,5,10,5,20
11,1948,"London","DEN","Denmark",10,5,7,8,20
11,1948,"London","NED","Netherlands",11,5,2,9,16
11,1948,"London","GBR","Great Britain",12,3,14,6,23
11,1948,"London","ARG","Argentina",13,3,3,1,7
11,1948,"London","AUS","Australia",14,2,6,5,13
11,1948,"London","BEL","Belgium",15,2,2,3,7
11,1948,"London","EGY","Egypt",16,2,2,1,5
11,1948,"London","MEX","Mexico",17,2,1,2,5
11,1948,"London","RSA","South Africa",18,2,1,1,4
11,1948,"London","NOR","Norway",19,1,3,3,7
11,1948,"London","JAM","Jamaica",20,1,2,0,3
11,1948,"London","AUT","Austria",21,1,0,3,4
11,1948,"London","IND","India",22,1,0,0,1
11,1948,"London","PER","Peru",22,1,0,0,1
11,1948,"London","YUG","Yugoslavia",24,0,2,0,2
11,1948,"London","CAN","Canada",25,0,1,2,3
11,1948,"London","POR","Portugal",26,0,1,1,2
11,1948,"London","URU","Uruguay",26,0,1,1,2
11,1948,"London","CEY","Ceylon",28,0,1,0,1
11,1948,"London","CUB","Cuba",28,0,1,0,1
11,1948,"London","ESP","Spain",28,0,1,0,1
11,1948,"London","TRI","Trinidad and Tobago",28,0,1,0,1
11,1948,"London","KOR","South Korea",32,0,0,2,2
11,1948,"London","PAN","Panama",32,0,0,2,2
11,1948,"London","BRA","Brazil",34,0,0,1,1
11,1948,"London","IRI","Iran",34,0,0,1,1
11,1948,"London","POL","Poland",34,0,0,1,1
11,1948,"London","PUR","Puerto Rico",34,0,0,1,1
10,1936,"Berlin","GER","Germany",1,33,26,30,89
10,1936,"Berlin","USA","United States",2,24,20,12,56
10,1936,"Berlin","HUN","Hungary",3,10,1,5,16
10,1936,"Berlin","ITA","Italy",4,8,9,5,22
10,1936,"Berlin","FIN","Finland",5,7,6,6,19
10,1936,"Berlin","FRA","France",5,7,6,6,19
10,1936,"Berlin","SWE","Sweden",7,6,5,9,20
10,1936,"Berlin","JPN","Japan",8,6,4,8,18
10,1936,"Berlin","NED","Netherlands",9,6,4,7,17
10,1936,"Berlin","GBR","Great Britain",10,4,7,3,14
10,1936,"Berlin","AUT","Austria",11,4,6,3,13
10,1936,"Berlin","TCH","Czechoslovakia",12,3,5,0,8
10,1936,"Berlin","ARG","Argentina",13,2,2,3,7
10,1936,"Berlin","EST","Estonia",13,2,2,3,7
10,1936,"Berlin","EGY","Egypt",15,2,1,2,5
10,1936,"Berlin","SUI","Switzerland",16,1,9,5,15
10,1936,"Berlin","CAN","Canada",17,1,3,5,9
10,1936,"Berlin","NOR","Norway",18,1,3,2,6
10,1936,"Berlin","TUR","Turkey",19,1,0,1,2
10,1936,"Berlin","IND","India",20,1,0,0,1
10,1936,"Berlin","NZL","New Zealand",20,1,0,0,1
10,1936,"Berlin","POL","Poland",22,0,3,3,6
10,1936,"Berlin","DEN","Denmark",23,0,2,3,5
10,1936,"Berlin","LAT","Latvia",24,0,1,1,2
10,1936,"Berlin","ROU","Romania",25,0,1,0,1
10,1936,"Berlin","RSA","South Africa",25,0,1,0,1
10,1936,"Berlin","YUG","Yugoslavia",25,0,1,0,1
10,1936,"Berlin","MEX","Mexico",28,0,0,3,3
10,1936,"Berlin","BEL","Belgium",29,0,0,2,2
10,1936,"Berlin","AUS","Australia",30,0,0,1,1
10,1936,"Berlin","PHI","Philippines",30,0,0,1,1
10,1936,"Berlin","POR","Portugal",30,0,0,1,1
9,1932,"Los Angeles","USA","United States",1,41,32,30,103
9,1932,"Los Angeles","ITA","Italy",2,12,12,12,36
9,1932,"Los Angeles","FRA","France",3,10,5,4,19
9,1932,"Los Angeles","SWE","Sweden",4,9,5,9,23
9,1932,"Los Angeles","JPN","Japan",5,7,7,4,18
9,1932,"Los Angeles","HUN","Hungary",6,6,4,5,15
9,1932,"Los Angeles","FIN","Finland",7,5,8,12,25
9,1932,"Los Angeles","GBR","Great Britain",8,4,7,5,16
9,1932,"Los Angeles","GER","Germany",9,3,12,5,20
9,1932,"Los Angeles","AUS","Australia",10,3,1,1,5
9,1932,"Los Angeles","ARG","Argentina",11,3,1,0,4
9,1932,"Los Angeles","CAN","Canada",12,2,5,8,15
9,1932,"Los Angeles","NED","Netherlands",13,2,5,0,7
9,1932,"Los Angeles","POL","Poland",14,2,1,4,7
9,1932,"Los Angeles","RSA","South Africa",15,2,0,3,5
9,1932,"Los Angeles","IRL","Ireland",16,2,0,0,2
9,1932,"Los Angeles","TCH","Czechoslovakia",17,1,2,1,4
9,1932,"Los Angeles","AUT","Austria",18,1,1,3,5
9,1932,"Los Angeles","IND","India",19,1,0,0,1
9,1932,"Los Angeles","DEN","Denmark",20,0,3,3,6
9,1932,"Los Angeles","MEX","Mexico",21,0,2,0,2
9,1932,"Los Angeles","LAT","Latvia",22,0,1,0,1
9,1932,"Los Angeles","NZL","New Zealand",22,0,1,0,1
9,1932,"Los Angeles","SUI","Switzerland",22,0,1,0,1
9,1932,"Los Angeles","PHI","Philippines",25,0,0,3,3
9,1932,"Los Angeles","ESP","Spain",26,0,0,1,1
9,1932,"Los Angeles","URU","Uruguay",26,0,0,1,1
8,1928,"Amsterdam","USA","United States",1,22,18,16,56
8,1928,"Amsterdam","GER","Germany",2,10,7,14,31
8,1928,"Amsterdam","FIN","Finland",3,8,8,9,25
8,1928,"Amsterdam","SWE","Sweden",4,7,6,12,25
8,1928,"Amsterdam","ITA","Italy",5,7,5,7,19
8,1928,"Amsterdam","SUI","Switzerland",6,7,4,4,15
8,1928,"Amsterdam","FRA","France",7,6,10,5,21
8,1928,"Amsterdam","NED","Netherlands",8,6,9,4,19
8,1928,"Amsterdam","HUN","Hungary",9,4,5,0,9
8,1928,"Amsterdam","CAN","Canada",10,4,4,7,15
8,1928,"Amsterdam","GBR","Great Britain",11,3,10,7,20
8,1928,"Amsterdam","ARG","Argentina",12,3,3,1,7
8,1928,"Amsterdam","DEN","Denmark",13,3,1,2,6
8,1928,"Amsterdam","TCH","Czechoslovakia",14,2,5,2,9
8,1928,"Amsterdam","JPN","Japan",15,2,2,1,5
8,1928,"Amsterdam","EST","Estonia",16,2,1,2,5
8,1928,"Amsterdam","EGY","Egypt",17,2,1,1,4
8,1928,"Amsterdam","AUT","Austria",18,2,0,1,3
8,1928,"Amsterdam","AUS","Australia",19,1,2,1,4
8,1928,"Amsterdam","NOR","Norway",19,1,2,1,4
8,1928,"Amsterdam","POL","Poland",21,1,1,3,5
8,1928,"Amsterdam","YUG","Yugoslavia",21,1,1,3,5
8,1928,"Amsterdam","RSA","South Africa",23,1,0,2,3
8,1928,"Amsterdam","IND","India",24,1,0,0,1
8,1928,"Amsterdam","IRL","Ireland",24,1,0,0,1
8,1928,"Amsterdam","NZL","New Zealand",24,1,0,0,1
8,1928,"Amsterdam","ESP","Spain",24,1,0,0,1
8,1928,"Amsterdam","URU","Uruguay",24,1,0,0,1
8,1928,"Amsterdam","BEL","Belgium",29,0,1,2,3
8,1928,"Amsterdam","CHI","Chile",30,0,1,0,1
8,1928,"Amsterdam","HAI","Haiti",30,0,1,0,1
8,1928,"Amsterdam","PHI","Philippines",32,0,0,1,1
8,1928,"Amsterdam","POR","Portugal",32,0,0,1,1
7,1924,"Paris","USA","United States",1,45,27,27,99
7,1924,"Paris","FIN","Finland",2,14,13,10,37
7,1924,"Paris","FRA","France",3,13,15,10,38
7,1924,"Paris","GBR","Great Britain",4,9,13,12,34
7,1924,"Paris","ITA","Italy",5,8,3,5,16
7,1924,"Paris","SUI","Switzerland",6,7,8,10,25
7,1924,"Paris","NOR","Norway",7,5,2,3,10
7,1924,"Paris","SWE","Sweden",8,4,13,12,29
7,1924,"Paris","NED","Netherlands",9,4,1,5,10
7,1924,"Paris","BEL","Belgium",10,3,7,3,13
7,1924,"Paris","AUS","Australia",11,3,1,2,6
7,1924,"Paris","DEN","Denmark",12,2,5,2,9
7,1924,"Paris","HUN","Hungary",13,2,3,4,9
7,1924,"Paris","YUG","Yugoslavia",14,2,0,0,2
7,1924,"Paris","TCH","Czechoslovakia",15,1,4,5,10
7,1924,"Paris","ARG","Argentina",16,1,3,2,6
7,1924,"Paris","EST","Estonia",17,1,1,4,6
7,1924,"Paris","RSA","South Africa",18,1,1,1,3
7,1924,"Paris","URU","Uruguay",19,1,0,0,1
7,1924,"Paris","AUT","Austria",20,0,3,1,4
7,1924,"Paris","CAN","Canada",20,0,3,1,4
7,1924,"Paris","POL","Poland",22,0,1,1,2
7,1924,"Paris","HAI","Haiti",23,0,0,1,1
7,1924,"Paris","JPN","Japan",23,0,0,1,1
7,1924,"Paris","NZL","New Zealand",23,0,0,1,1
7,1924,"Paris","POR","Portugal",23,0,0,1,1
7,1924,"Paris","ROU","Romania",23,0,0,1,1
6,1920,"Antwerp","USA","United States",1,41,27,27,95
6,1920,"Antwerp","SWE","Sweden",2,19,20,25,64
6,1920,"Antwerp","GBR","Great Britain",3,15,15,13,43
6,1920,"Antwerp","FIN","Finland",4,15,10,9,34
6,1920,"Antwerp","BEL","Belgium",5,14,11,11,36
6,1920,"Antwerp","NOR","Norway",6,13,9,9,31
6,1920,"Antwerp","ITA","Italy",7,13,5,5,23
6,1920,"Antwerp","FRA","France",8,9,19,13,41
6,1920,"Antwerp","NED","Netherlands",9,4,2,5,11
6,1920,"Antwerp","DEN","Denmark",10,3,9,1,13
6,1920,"Antwerp","RSA","South Africa",11,3,4,3,10
6,1920,"Antwerp","CAN","Canada",12,3,3,3,9
6,1920,"Antwerp","SUI","Switzerland",13,2,2,7,11
6,1920,"Antwerp","EST","Estonia",14,1,2,0,3
6,1920,"Antwerp","BRA","Brazil",15,1,1,1,3
6,1920,"Antwerp","AUS","Australia",16,0,2,1,3
6,1920,"Antwerp","JPN","Japan",17,0,2,0,2
6,1920,"Antwerp","ESP","Spain",17,0,2,0,2
6,1920,"Antwerp","GRE","Greece",19,0,1,0,1
6,1920,"Antwerp","LUX","Luxembourg",19,0,1,0,1
6,1920,"Antwerp","TCH","Czechoslovakia",21,0,0,2,2
6,1920,"Antwerp","NZL","New Zealand",22,0,0,1,1
5,1912,"Stockholm","USA","United States",1,25,19,19,63
5,1912,"Stockholm","SWE","Sweden",2,24,24,17,65
5,1912,"Stockholm","GBR","Great Britain",3,10,15,16,41
5,1912,"Stockholm","FIN","Finland",4,9,8,9,26
5,1912,"Stockholm","FRA","France",5,7,4,3,14
5,1912,"Stockholm","GER","Germany",6,5,13,7,25
5,1912,"Stockholm","RSA","South Africa",7,4,2,0,6
5,1912,"Stockholm","NOR","Norway",8,4,1,4,9
5,1912,"Stockholm","CAN","Canada",9,3,2,3,8
5,1912,"Stockholm","HUN","Hungary",9,3,2,3,8
5,1912,"Stockholm","ITA","Italy",11,3,1,2,6
5,1912,"Stockholm","ANZ","Australasia",12,2,2,3,7
5,1912,"Stockholm","BEL","Belgium",13,2,1,3,6
5,1912,"Stockholm","DEN","Denmark",14,1,6,5,12
5,1912,"Stockholm","GRE","Greece",15,1,0,1,2
5,1912,"Stockholm","RUS","Russia",16,0,2,3,5
5,1912,"Stockholm","AUT","Austria",17,0,2,2,4
5,1912,"Stockholm","NED","Netherlands",18,0,0,3,3
4,1908,"London","GBR","Great Britain",1,56,51,39,146
4,1908,"London","USA","United States",2,23,12,12,47
4,1908,"London","SWE","Sweden",3,8,6,11,25
4,1908,"London","FRA","France",4,5,5,9,19
4,1908,"London","GER","Germany",5,3,5,5,13
4,1908,"London","HUN","Hungary",6,3,4,2,9
4,1908,"London","CAN","Canada",7,3,3,10,16
4,1908,"London","NOR","Norway",8,2,3,3,8
4,1908,"London","ITA","Italy",9,2,2,0,4
4,1908,"London","BEL","Belgium",10,1,5,2,8
4,1908,"London","ANZ","Australasia",11,1,2,2,5
4,1908,"London","RUS","Russia",12,1,2,0,3
4,1908,"London","FIN","Finland",13,1,1,3,5
4,1908,"London","RSA","South Africa",14,1,1,0,2
4,1908,"London","GRE","Greece",15,0,3,0,3
4,1908,"London","DEN","Denmark",16,0,2,3,5
4,1908,"London","BOH","Bohemia",17,0,0,2,2
4,1908,"London","NED","Netherlands",17,0,0,2,2
4,1908,"London","AUT","Austria",19,0,0,1,1
3,1904,"St. Louis","USA","United States",1,78,82,79,239
3,1904,"St. Louis","GER","Germany",2,4,4,5,13
3,1904,"St. Louis","CUB","Cuba",3,4,2,3,9
3,1904,"St. Louis","CAN","Canada",4,4,1,1,6
3,1904,"St. Louis","HUN","Hungary",5,2,1,1,4
3,1904,"St. Louis","GBR","Great Britain",6,1,1,0,2
3,1904,"St. Louis","ZZX","Mixed team",6,1,1,0,2
3,1904,"St. Louis","GRE","Greece",8,1,0,1,2
3,1904,"St. Louis","SUI","Switzerland",8,1,0,1,2
3,1904,"St. Louis","AUT","Austria",10,0,0,1,1
2,1900,"Paris","FRA","France",1,26,41,34,101
2,1900,"Paris","USA","United States",2,19,14,14,47
2,1900,"Paris","GBR","Great Britain",3,15,6,9,30
2,1900,"Paris","ZZX","Mixed team",4,6,3,3,12
2,1900,"Paris","SUI","Switzerland",5,6,2,1,9
2,1900,"Paris","BEL","Belgium",6,5,5,5,15
2,1900,"Paris","GER","Germany",7,4,2,2,8
2,1900,"Paris","ITA","Italy",8,2,2,0,4
2,1900,"Paris","AUS","Australia",9,2,0,3,5
2,1900,"Paris","DEN","Denmark",10,1,3,2,6
2,1900,"Paris","HUN","Hungary",11,1,2,2,5
2,1900,"Paris","CUB","Cuba",12,1,1,0,2
2,1900,"Paris","CAN","Canada",13,1,0,1,2
2,1900,"Paris","ESP","Spain",14,1,0,0,1
2,1900,"Paris","AUT","Austria",15,0,3,3,6
2,1900,"Paris","NOR","Norway",16,0,2,3,5
2,1900,"Paris","IND","India",17,0,2,0,2
2,1900,"Paris","NED","Netherlands",18,0,1,3,4
2,1900,"Paris","BOH","Bohemia",19,0,1,1,2
2,1900,"Paris","MEX","Mexico",20,0,0,1,1
2,1900,"Paris","SWE","Sweden",20,0,0,1,1
1,1896,"Athens","USA","United States",1,11,7,2,20
1,1896,"Athens","GRE","Greece",2,10,17,19,46
1,1896,"Athens","GER","Germany",3,6,5,2,13
1,1896,"Athens","FRA","France",4,5,4,2,11
1,1896,"Athens","GBR","Great Britain",5,2,3,2,7
1,1896,"Athens","HUN","Hungary",6,2,1,3,6
1,1896,"Athens","AUT","Austria",7,2,1,2,5
1,1896,"Athens","AUS","Australia",8,2,0,0,2
1,1896,"Athens","DEN","Denmark",9,1,2,3,6
1,1896,"Athens","SUI","Switzerland",10,1,2,0,3
1,1896,"Athens","ZZX","Mixed team",11,1,1,1,3
